7 7
#######
##ddd##
#oXXXd#
#oXPXo#
#dXXXo#
##ddoo#
#######